1111111111111
100C0000000P1
1000001111001
1C000E00000C1
1111111111111