1111111111111
1P000C0000C01
1000001111001
10000E000C001
1111111111111