1111111111111
1P0C000000C01
1000001111001
1C000E00000C1
1111111111111