1111111111111
1P00000000C01
1000001111001
10000E00C0001
1111111111111