1111111111111
10P1E000000C1
1C00C11111001
10011C0000001
1111111111111