1111111111111
101C0000000P1
1000011111001
1C011E00000C1
1111111111111