1111111111111
1001000000001
1000010000001
1111111111111
1111111111111
1P0C00E000001
1111111111111
1101101000111
1101101111011
1110001000011
1111101011111
1111101100011
1111111111111
1111111111111