1111111111111111111111111111111111
10CCCCCCCCCCCCCCCCCCCCCCCCCCCCCC01
10CCCCCCCCCCCCCCCCCCCCCCCCCCCCC001
1000CCCCCCCCCCCCCCCCCCCCCCCCCC0001
10000C000000000100CCCCCCCCCCCCCCC1
100000000000000100CCCCCCCCCCCCCCC1
1000000000000001000CCCCCCCCCCCCCC1
10000000000000010CCCCCCCCCCCCCC001
100000000C0000010CCCCCCCCCCCCCCC01
10000000000000010CCCCCCCCCCCCCCCC1
10CCCCCCCCCCCCCCCCCCCCCCCCCCCCCC01
100CCCCCCCCCCCCCCCCCCCCCCCCCCCCCC1
10CCCCCCCCCCCCCCCCCCCCCCCCCCCCCCC1
10CCCCCCCCCCCCCCCCCCCCCCCCCCCCCCC1
10CCCCCCCCCCCCCCCCCCCCCCCCCCCCCCC1
10CCCCCCCCCCCCCCCCCCCCCCCCCCCCCC01
10CCCCCCCCCCCCCCCCCCCCCCCCCCCCCCC1
10CCCCCCCCCCCCCCCCPCCCCCCCCCC00E01
10CCCCCCCCCCCCCCCCCCCCCCCCCCCCCC01
1111111111111111111111111111111111