1111111111111
1CCCCCCCC00P1
1C00001111001
10000E0000001
1111111111111