1111111111111
10000C0000CP1
1000001111001
10000E000C001
1111111111111