1111111111111
1P0000000C001
1000001111001
10C00E00000C1
1111111111111