1111111111111
1C000C0C00CP1
1C000011110C1
10000ECC0C0C1
1111111111111