1111111111111
1PCCCCCCCCCC1
10000011110C1
10000E00000C1
1111111111111